48
45
o o o o o o o o o o o o o o o o o o o o o o o o o o o o o o o o o o o o o o o o o o o o o o o o
o o o o o o o o o o o o o o o o o o o o o o o o o o o o o o o o o o o o o o o o o o o o o o o o
o o o o o o o o o o o o o o o o o o o o o o o o o o o o o o o o o o o o o o o o o o o o o o o o
o o o x x x x x x x x x x x x x x x x x x x x x x x x o o o x x x o o o x x x o o o x x x o o o
o o o x x x x x x x x x x x x x x x x x x x x x x x x o o o x x x o o o x x x o o o x x x o o o
o o o x x x x x x x x x x x x x x x x x x x x x x x x o o o x x x o o o x x x o o o x x x o o o
o o o x x x o o o o o o o o o o o o o o o o o o o o o o o o x x x o o o x x x o o o x x x o o o
o o o x x x o o o o o o o o o o o o o o o o o o o o o o o o x x x o o o x x x o o o x x x o o o
o o o x x x o o o o o o o o o o o o o o o o o o o o o o o o x x x o o o x x x o o o x x x o o o
o o o x x x o o o x x x x x x x x x x x x x x x x x x x x x x x x o o o x x x o o o x x x o o o
o o o x x x o o o x x x x x x x x x x x x x x x x x x x x x x x x o o o x x x o o o x x x o o o
o o o x x x o o o x x x x x x x x x x x x x x x x x x x x x x x x o o o x x x o o o x x x o o o
o o o x x x o o o x x x o o o o o o o o o o o o o o o o o o o o o o o o x x x o o o x x x o o o
o o o x x x o o o x x x o o o o o o o o o o o o o o o o o o o o o o o o x x x o o o x x x o o o
o o o x x x o o o x x x o o o o o o o o o o o o o o o o o o o o o o o o x x x o o o x x x o o o
o o o x x x o o o x x x o o o x x x x x x x x x x x x x x x x x x o o o x x x o o o x x x o o o
o o o x x x o o o x x x o o o x x x x x x x x x x x x x x x x x x o o o x x x o o o x x x o o o
o o o x x x o o o x x x o o o x x x x x x x x x x x x x x x x x x o o o x x x o o o x x x o o o
o o o x x x o o o x x x o o o o o o o o o o o o o o o o o o x x x o o o x x x o o o x x x o o o
o o o x x x o o o x x x o o o o o o o o o o o o o o o o o o x x x o o o x x x o o o x x x o o o
o o o x x x o o o x x x o o o o o o o o o o o o o o o o o o x x x o o o x x x o o o x x x o o o
o o o o o o o o o x x x x x x x x x x x x x x x x x x o o o x x x o o o x x x o o o x x x o o o
o o o o o o o o o x x x x x x x x x x x x x x x x x x o o o x x x o o o x x x o o o x x x o o o
o o o o o o o o o x x x x x x x x x x x x x x x x x x o o o x x x o o o x x x o o o x x x o o o
o o o x x x o o o x x x o o o o o o o o o o o o o o o o o o x x x o o o x x x x x x x x x o o o
o o o x x x o o o x x x o o o o o o o o o o o o o o o o o o x x x o o o x x x x x x x x x o o o
o o o x x x o o o x x x o o o o o o o o o o o o o o o o o o x x x o o o x x x x x x x x x o o o
o o o x x x o o o x x x x x x o o o x x x o o o x x x x x x x x x o o o x x x o o o x x x o o o
o o o x x x o o o x x x x x x o o o x x x o o o x x x x x x x x x o o o x x x o o o x x x o o o
o o o x x x o o o x x x x x x o o o x x x o o o x x x x x x x x x o o o x x x o o o x x x o o o
o o o x x x o o o x x x o o o o o o x x x o o o x x x o o o o o o o o o x x x o o o o o o o o o
o o o x x x o o o x x x o o o o o o x x x o o o x x x o o o o o o o o o x x x o o o o o o o o o
o o o x x x o o o x x x o o o o o o x x x o o o x x x o o o o o o o o o x x x o o o o o o o o o
o o o x x x o o o x x x x x x o o o x x x o o o x x x o o o x x x x x x x x x o o o x x x o o o
o o o x x x o o o x x x x x x o o o x x x o o o x x x o o o x x x x x x x x x o o o x x x o o o
o o o x x x o o o x x x x x x o o o x x x o o o x x x o o o x x x x x x x x x o o o x x x o o o
o o o x x x o o o x x x o o o o o o x x x o o o x x x o o o o o o o o o o o o o o o x x x o o o
o o o x x x o o o x x x o o o o o o x x x o o o x x x o o o o o o o o o o o o o o o x x x o o o
o o o x x x o o o x x x o o o o o o x x x o o o x x x o o o o o o o o o o o o o o o x x x o o o
o o o x x x o o o x x x o o o x x x x x x x x x x x x x x x x x x x x x x x x o o o x x x o o o
o o o x x x o o o x x x o o o x x x x x x x x x x x x x x x x x x x x x x x x o o o x x x o o o
o o o x x x o o o x x x o o o x x x x x x x x x x x x x x x x x x x x x x x x o o o x x x o o o
s s s x x x o o o x x x o o o o o o o o o x x x e e e o o o o o o o o o o o o o o o x x x o o o
s s s x x x o o o x x x o o o o o o o o o x x x e e e o o o o o o o o o o o o o o o x x x o o o
s s s x x x o o o x x x o o o o o o o o o x x x e e e o o o o o o o o o o o o o o o x x x o o o