32
30
o o o o o o o o o o o o o o o o o o o o o o o o o o o o o o o o
o o o o o o o o o o o o o o o o o o o o o o o o o o o o o o o o
o o x x x x x x x x x x x x x x x x o o x x o o x x o o x x o o
o o x x x x x x x x x x x x x x x x o o x x o o x x o o x x o o
o o x x o o o o o o o o o o o o o o o o x x o o x x o o x x o o
o o x x o o o o o o o o o o o o o o o o x x o o x x o o x x o o
o o x x o o x x x x x x x x x x x x x x x x o o x x o o x x o o
o o x x o o x x x x x x x x x x x x x x x x o o x x o o x x o o
o o x x o o x x o o o o o o o o o o o o o o o o x x o o x x o o
o o x x o o x x o o o o o o o o o o o o o o o o x x o o x x o o
o o x x o o x x o o x x x x x x x x x x x x o o x x o o x x o o
o o x x o o x x o o x x x x x x x x x x x x o o x x o o x x o o
o o x x o o x x o o o o o o o o o o o o x x o o x x o o x x o o
o o x x o o x x o o o o o o o o o o o o x x o o x x o o x x o o
o o o o o o x x x x x x x x x x x x o o x x o o x x o o x x o o
o o o o o o x x x x x x x x x x x x o o x x o o x x o o x x o o
o o x x o o x x o o o o o o o o o o o o x x o o x x x x x x o o
o o x x o o x x o o o o o o o o o o o o x x o o x x x x x x o o
o o x x o o x x x x o o x x o o x x x x x x o o x x o o x x o o
o o x x o o x x x x o o x x o o x x x x x x o o x x o o x x o o
o o x x o o x x o o o o x x o o x x o o o o o o x x o o o o o o
o o x x o o x x o o o o x x o o x x o o o o o o x x o o o o o o
o o x x o o x x x x o o x x o o x x o o x x x x x x o o x x o o
o o x x o o x x x x o o x x o o x x o o x x x x x x o o x x o o
o o x x o o x x o o o o x x o o x x o o o o o o o o o o x x o e
o o x x o o x x o o o o x x o o x x o o o o o o o o o o x x o o
o o x x o o x x o o x x x x x x x x x x x x x x x x o o x x o o
o o x x o o x x o o x x x x x x x x x x x x x x x x o o x x o o
o o x x o o x x o o o o o o x x o o o o o o o o o o o o x x o o
s o x x o o x x o o o o o o x x e o o o o o o o o o o o x x o o